TITLES = https://www.gametdb.com (type: Switch language: EN version: 20180825171857)
AAAAA = The Legend of Zelda: Breath of the Wild
AAACA = Super Mario Odyssey
AAB6A = Splatoon 2
AAB6B = Splatoon 2
AAB6C = Splatoon 2
AAB7A = Monster Hunter XX: Double Cross Nintendo Switch Ver.
AAB8A = Super Bomberman R
AABPA = Mario Kart 8 Deluxe
AABQA = ARMS
AACAC = Disgaea 5 Complete
AACCA = 1-2-Switch
AB36A = Troll and I
AB38A = NBA 2K18
AB39A = RiME
AB4JA = The LEGO NINJAGO Movie Video Game
AB4JB = The LEGO NINJAGO Movie Video Game
AB4JC = The LEGO NINJAGO Movie Video Game
AB5JB = Soldam: Drop, Connect, Erase
AB92A = Cave Story+
AB93A = Ittle Dew 2+
AB96A = Tiny Barbarian DX
ABD7C = Sonic Mania Plus
ABM2A = LEGO City Undercover
ABMKA = Has Been Heroes
ABQLA = Sonic Forces
ABQLB = Sonic Forces
ABQLC = Sonic Forces
ABTCB = Wonder Boy: The Dragon's Trap
ABTDA = Cars 3: Driven to Win
ABTDB = Cars 3: Driven to Win
ABTDC = Cars 3: Driven to Win
ABWUA = Nobunaga no Yabou: Souzou with Power Up Kit
ABYBA = Dragon Ball Xenoverse 2
AC8QA = Fate/Extella: The Umbral Star
ACC2A = Resident Evil: Revelations Collection
ACD3A = VOEZ
ACL4A = LEGO Worlds
ACL9A = One Piece: Unlimited World R Deluxe Edition
ACNGB = Runner3
ACS3A = Minecraft: Story Mode - The Complete Adventure
ACVKA = Rayman Legends: Definitive Edition
ACVKB = Rayman Origins: Definitive Edition
ACXPA = Dragon Quest Builders
AD2DA = Nobunaga no Yabou: Taishi
AD6QA = Harvest Moon: Light of Hope - Special Edition
AD6QB = Harvest Moon: Light of Hope - Special Edition
AD77A = Syberia
AD78A = Syberia 2
AD79B = Gear.Club Unlimited
AD7TA = Armed Blue Gunvolt Striker Pack
AD9BA = Touhou Kobuto V: Burst Battle
ADAVA = Seiken Densetsu Collection
ADCEA = FIFA 18
ADEBA = Just Dance 2018
ADENA = Xenoblade 2
ADENB = Xenoblade Chronicles 2
ADFUA = Nintendo Labo - Toy-Con 01: Variety Kit
ADFVA = Nintendo Labo - Toy-Con 02: Robot Kit
ADK7A = Monster Jam: Crush It!
ADLRA = Sine Mora EX
ADMMA = Rocket League
ADQPA = Monopoly for Nintendo Switch
ADWFA = Nights of Azure 2: Bride of the New Moon
ADWFB = Nights of Azure 2: Bride of the New Moon
ADWYA = Lost Sphear
ADXHA = Fire Emblem Warriors
ADXHB = Fire Emblem Warriors
ADYFA = Winning Post 8 2017
AE98A = Bayonetta 2
AEABB = Poi: Explorer Edition
AEANA = LEGO Marvel Super Heroes 2
AEANB = LEGO Marvel Super Heroes 2
AEANC = LEGO Marvel Super Heroes 2
AECNA = Shingeki no Kyojin 2
AECRA = Retro City Rampage DX
AECYA = Portal Knights
AEDXA = Scribblenauts Showdown
AEESA = Champion Jockey Special
AEG7A = R.B.I. Baseball 17
AEJQA = Axiom Verge
AEQKA = Overcooked: Special Edition
AES8A = Ben 10
AESEA = Farming Simulator: Nintendo Switch Edition
AESEB = Farming Simulator: Nintendo Switch Edition
AEXYA = Snipperclips Plus: Cut It Out, Together!
AF3BA = DOOM
AF3CA = The Elder Scrolls V: Skyrim
AF49A = Atelier Lydie & Soeur: Fushigi na Kaiga no Renkinjutsu Samurai
AFCAA = Sumikko Gurashi: Sumikko Park e Youkoso
AFHRA = This is the Police
AFLHA = Lumo
AFLJA = 88 Heroes: 98 Heroes Edition
AFLSA = The Longest Five Minutes
AFQMA = L.A. Noire
AFQMC = L.A. Noire
AFVHA = South Park: The Fractured But Whole
AFVPA = Unbox: Newbie's Adventure
AFVWA = Snow Moto Racing Freedom
AFWTA = Donkey Kong Country: Tropical Freeze
AGCYA = Asonde Shogi ga Tsuyokunaru! Ginsei Shogi DX
AGK2A = Super Putty Squad
AGLQA = Stern Pinball Arcade
AGV2A = Sengoku Musou: Sanada Maru
AGVVA = Musou Orochi 2 Ultimate
AGVYA = Shin Sangoku Musou 7 Empires
AGW3A = Batman: The Telltale Series
AGXWA = MXGP3: The Official Motocross Videogame
AGY7B = Octopath Traveler
AH26A = Kirby Star Allies
AH3EA = LEGO The Incredibles
AHABA = Party Planet
AJ6HA = Anata no Shikihime Kyouikutan
AJA8A = One Piece: Kaizoku Musou 3 - Deluxe Edition
AJAMA = 3D MiniGolf
AJJ7A = Monster Energy Supercross: The Official Videogame
AJMUA = The Snack World: Trejarers Gold
AK6JA = Street Fighter™ 30th Anniversary Collection
AKUTA = Zelda Musou: Hyrule All Stars DX
AKUTB = Hyrule Warriors: Definitive Edition
ALECA = Winning Post 8 2018
ALERA = Mario Tennis Aces
ALXDA = Happy Birthdays
ALXDC = Happy Birthdays
AMSGA = Shantae: Half-Genie Hero Ultimate Edition
AMSGB = Shantae: Half-Genie Hero Ultimate Edition
AN33A = Owlboy
APMBA = All-Star Fruit Racing
BAAAA = Just Dance 2017
BAACA = Puyo Puyo Tetris
BAACB = Puyo Puyo Tetris
BAACC = Puyo Puyo Tetris
BAANA = Mario + Rabbids: Kingdom Battle
BAAVA = Minna de Waiwai! Spelunker
BAAYA = Pokken Tournament DX
BAAZA = The Binding of Isaac: Afterbirth+
BABBD = Ultra Street Fighter II: The Final Challengers
BABBE = Ultra Street Fighter II: The Final Challengers
BABJA = Ikenie to Yuki no Setsuna
BABKA = Dragon Quest Heroes I・II for Nintendo Switch
